11111111111111111111
10002000000020000001
10111111111111111111
10100000000000000001
10111111111111111101
10100000000000000001
10111111111111111001
10100000000000001001
10111111111111111101
10100000000000000001
10101111111011111101
10100000000000000001
10111111111111111101
10000000000000000001
11111111111111111111