11111111111111111111
10000000000020000001
10111111111111111111
10100000000000000001
10111111111111111101
10100000000000000001
10111111011111111001
10100001000000001001
10111111111111111101
10100020000000000001
10101111111011111101
10100000020000000001
10111111111111111101
10000000000000000001
11111111111111111111
